IPA	SAMPA
ə	@
a	a
ɛ	E
e	e
i	i
ɔ	O
o	o
u	u
p	p
b	b
t	t
d	d
k	k
g	g
m	m
ɱ	F
n	n
ɲ	J
ŋ	N
r	rr
ɾ	r
f	f
v	v
s	s
z	z
ʃ	S
ʒ	Z
ts	ts
dz	dz
tʃ	tS
dʒ	tZ
β	B
ð	D
ɣ	G
j	j
w	w
l	l
ʎ	L
'	`
'	"